{
  "terrains": {
    "+": 1,
    "-": 50,
    "^": 6,
    "o": 2,
    "t": 14,
    "~": 20
  },
  "map": [
    ".................~.....~................",
    "---------------tt~-^^^-~----------------",
    "--T------------~~~-^T^t~t---------------",
    "-^^---t-------t~t--^^-t~~t--------------",
    "-T^-----------t~~-T^T--t~t-------t------",
    "-^---------òò-tt~t^^-oot~t--------------",
    "-----------òò--t~t^--t~~~o------tt------",
    "-----tt--------t~~ttt~~tt------tTTT-----",
    "-----ttt------ttt~t~~~ttt-----tTTót-----",
    "----tt~~tt---t~~~~~~tttt------TTt-------",
    "-----t~~tt--tt~otttttt------------------",
    "-----ttttt-tTt~~tTTTt-----TT------------",
    "------tttt-TTTt~tTTT--t---TT------------",
    "---^^-----TTTtt~tTT-------^-------------",
    "--^T^----tTttt~~t--------^--------------",
    "---^------^o~~~tt-t----TT---------ttt---",
    "----------to~ttt-------TT---------ttt---",
    "----------o~~tt--------------------t----",
    "----------t~ttt-t-----------------------",
    "----------t~ttt-------------------------",
    "----------t~~tt---A---------------------",
    "---tTT----tt~tt-----------òò---ttt^^----",
    "--tTTTT----t~~~t----------òò--ttttt^^---",
    "--TTTt--tt--tt~t------t-------t~~~tt^---",
    "--------tt---t~------tt--~~----~~~ttt---",
    "---~~~~o--++-~~~--------o~~~o---tttt----",
    "---~~~~~~~o--~~~~~~~~~--~~~~~~o---------",
    "-~~~~~~~~~~~~~~~~~~~~~~~~~~~~~~~--~~~---",
    "~~~~~~~~~~~~~~~~~~~~~~~~~~~~~~~~~~~~~~~~",
    "~~~~~~~~~~~~~~~~~~~~~~~~~~~~~~~~~~~~~~~~",
    "~~~~~~~~~~~~~~~~~~~~~~~~~~~~~~~~~~~~~~~~",
    "~~~~~~~~~~~~~~~~~~~~~~~~~~~~~~~~~~~~~~~~"
  ],
  "achievements": [
    "landscape-architect",
    "fisherman-guild",
    "pioneer"
  ],
  "description": [
    "A medium-sized (40x40) map with a coastline and a river. Plenty of all resources.",
    "Available random tiles: 500."
  ],
  "center": {
    "X": 18,
    "Y": 20
  },
  "initial_terrains": 500
}