{
  "terrains": {
    "+": 1,
    "-": 50,
    "^": 6,
    "r": 2,
    "t": 14,
    "~": 20
  },
  "map": [
    ".................~.....~................",
    "---------------tt~-^^^-~----------------",
    "--T------------~~~-^T^t~t---------------",
    "-^^---t-------t~t--^^-t~~t--------------",
    "-T^-----------t~~-T^T--t~t-------t------",
    "-^---------UU-tt~t^^-rrt~t--------------",
    "-----------UU--t~t^--t~~~r------tt------",
    "-----tt--------t~~ttt~~tt------tTTT-----",
    "-----ttt------ttt~t~~~ttt-----tTTRt-----",
    "----tt~~tt---t~~~~~~tttt------TTt-------",
    "-----t~~tt--tt~rtttttt------------------",
    "-----ttttt-tTt~~tTTTt-----TT------------",
    "------tttt-TTTt~tTTT--t---TT------------",
    "---^^-----TTTtt~tTT-------^-------------",
    "--^T^----tTttt~~t--------^--------------",
    "---^------^r~~~tt-t----TT---------ttt---",
    "----------tr~ttt-------TT---------ttt---",
    "----------r~~tt--------------------t----",
    "----------t~ttt-t-----------------------",
    "----------t~ttt-------------------------",
    "----------t~~tt---h---------------------",
    "---tTT----tt~tt-----------UU---ttt^^----",
    "--tTTTT----t~~~t----------UU--ttttt^^---",
    "--TTTt--tt--tt~t------t-------t~~~tt^---",
    "--------tt---t~------tt--~~----~~~ttt---",
    "---~~~~r--++-~~~--------r~~~r---tttt----",
    "---~~~~~~~r--~~~~~~~~~--~~~~~~r---------",
    "-~~~~~~~~~~~~~~~~~~~~~~~~~~~~~~~--~~~---",
    "~~~~~~~~~~~~~~~~~~~~~~~~~~~~~~~~~~~~~~~~",
    "~~~~~~~~~~~~~~~~~~~~~~~~~~~~~~~~~~~~~~~~",
    "~~~~~~~~~~~~~~~~~~~~~~~~~~~~~~~~~~~~~~~~",
    "~~~~~~~~~~~~~~~~~~~~~~~~~~~~~~~~~~~~~~~~"
  ],
  "achievements": [],
  "description": [],
  "center": {
    "X": 18,
    "Y": 20
  },
  "initial_terrains": 500
}