{
  "terrains": {
    "+": 40,
    "-": 15,
    "^": 1,
    "r": 3,
    "t": 4,
    "~": 4
  },
  "map": [
    "....................++++++++++++.........",
    "................+++++++òò+++++++++.......",
    "..............++++++++òò+++++++++++......",
    "............++++ò++++++++++^--------.....",
    "..........++++òò++++++++++---tt-------...",
    ".........+++++òò+++++++++----~~~~tt----..",
    "........++ò+++++++++++++^---t~tt~~~~~---.",
    ".......++òò++++++++++++^---t~~tttttt~t---",
    "......+++++++++++++++++^---t~tt-----~~~~~",
    ".....+++++++++++++òò+++^---t~t-------t---",
    "....++++ò++++++++++ò+++---~~~----++^^----",
    "....+++òò++++++++++++++--t~tt--+++++++++-",
    "...++++ò++++++++++++++--t~~t--^+++òòò++++",
    "..+++++++++++++++++++---t~tt--^+++òò+++++",
    ".++ò+++++++++òò+++++^---t~tt--^+++ò++++++",
    ".++++++++++++òò+++++t----~~~--+++++++++ò+",
    ".++++++++++++++++++tt-----t~--+++++++++++",
    ".------++++++-------------t~--+++++++++++",
    ".---~~~-^+++--ttt--------t~~--+ò+++++++++",
    "~~~~~t~t----t~~~~ttt--A--t~t--+ò+++++++++",
    ".-ttt-~t---tt~tt~~~~t----t~t-+++++++++++.",
    ".-----~~ttt~~~---tt~ttt--~~--+++++++++++.",
    ".------~~~~~tt-----~~~~~-~t-^++++++++ò++.",
    ".++^^---tt----------ttt~~~--++++++++òò++.",
    ".++++^----+++++^-----------+++++++++òò+..",
    "..++++++++++++++^^^^+++++++++++++++òò++..",
    "...++ò+++ò++++++++++++++òò+++++++++++++..",
    "....+++++òòò+++++++++++++ò++++++++++++...",
    ".....+++++òòò+++++++++++++++++++++++++...",
    "......+++++òò++++++òò++++++++++++ò+++....",
    ".......++++++++++++++++++++++++++++++....",
    "........++++++++++++++++++++++++++++.....",
    ".........++++++++++++++++++ò+++++++......",
    "...........++++òò++++++++++++++++........",
    ".............+++òò++++++++++++++.........",
    "................+++++++++++++............",
    "..................++++++++..............."
   ],
   "achievements": [
      "landscape-architect"
   ],
   "description": [
     "A medium-sized (40x40) map with a green valley through a vast desert. Very limited on building space.",
     "Available random tiles: 500."
   ],
   "center": {
     "X": 22,
     "Y": 19
   },
   "initial_terrains": 500
}