{
  "terrains": {
    "+": 40,
    "-": 15,
    "^": 1,
    "r": 3,
    "t": 4,
    "~": 4
  },
  "map": [
    "....................++++++++++++.........",
    "................+++++++UU+++++++++.......",
    "..............++++++++UU+++++++++++......",
    "............++++U++++++++++^--------.....",
    "..........++++UU++++++++++---tt-------...",
    ".........+++++UU+++++++++----~~~~tt----..",
    "........++U+++++++++++++^---t~tt~~~~~---.",
    ".......++UU++++++++++++^---t~~tttttt~t---",
    "......+++++++++++++++++^---t~tt-----~~~~~",
    ".....+++++++++++++UU+++^---t~t-------t---",
    "....++++U++++++++++U+++---~~~----++^^----",
    "....+++UU++++++++++++++--t~tt--+++++++++-",
    "...++++U++++++++++++++--t~~t--^+++UUU++++",
    "..+++++++++++++++++++---t~tt--^+++UU+++++",
    ".++U+++++++++UU+++++^---t~tt--^+++U++++++",
    ".++++++++++++UU+++++t----~~~--+++++++++U+",
    ".++++++++++++++++++tt-----t~--+++++++++++",
    ".------++++++-------------t~--+++++++++++",
    ".---~~~-^+++--ttt--------t~~--+U+++++++++",
    "~~~~~t~t----t~~~~ttt--h--t~t--+U+++++++++",
    ".-ttt-~t---tt~tt~~~~t----t~t-+++++++++++.",
    ".-----~~ttt~~~---tt~ttt--~~--+++++++++++.",
    ".------~~~~~tt-----~~~~~-~t-^++++++++U++.",
    ".++^^---tt----------ttt~~~--++++++++UU++.",
    ".++++^----+++++^-----------+++++++++UU+..",
    "..++++++++++++++^^^^+++++++++++++++UU++..",
    "...++U+++U++++++++++++++UU+++++++++++++..",
    "....+++++UUU+++++++++++++U++++++++++++...",
    ".....+++++UUU+++++++++++++++++++++++++...",
    "......+++++UU++++++UU++++++++++++U+++....",
    ".......++++++++++++++++++++++++++++++....",
    "........++++++++++++++++++++++++++++.....",
    ".........++++++++++++++++++U+++++++......",
    "...........++++UU++++++++++++++++........",
    ".............+++UU++++++++++++++.........",
    "................+++++++++++++............",
    "..................++++++++..............."
   ],
   "achievements": [
      "landscape-architect"
   ],
   "description": [
     "A medium-sized (40x40) map with a green valley through a vast desert. Very limited on building space.",
     "Available random tiles: 500."
   ],
   "center": {
     "X": 22,
     "Y": 19
   },
   "initial_terrains": 500
}