{
  "terrains": {
    "-": 250,
    "^": 3,
    "r": 3,
    "t": 20,
    "~": 2
  },
  "map": [
    "-------------------------------------------",
    "----------------------------------tt-------",
    "-------------tt------------------tt--------",
    "-------------tt----------------------------",
    "----t--------------------------------------",
    "---t~--------------------------------------",
    "---t~--------------------TR----------------",
    "-------------------------R^----------------",
    "-------------------------------------------",
    "-------------ttt----------------------tt---",
    "------------ttttt--------------------tttt--",
    "------------tttT---------------------tttt--",
    "-------------t^^------------tt--------rT---",
    "---------------------------tttt--------R---",
    "--------------------------tt~~t------------",
    "---------------------------t~~tt-----------",
    "---------------------------ttttt-----------",
    "-------------r-------------RRtt------------",
    "--r----------r--------------R--------------",
    "-rT----------------------------------------",
    "--^----------------------------------------",
    "---------------------h---------------------",
    "---------------tt--------------------------",
    "--------------tttt-------------------------",
    "--------------ttttt------------------------",
    "---------------ttt-------------------------",
    "---------------------------------rtt-------",
    "---------------------------------ttt-------",
    "---------------------------------tt--------",
    "-------------------------------------------",
    "-------------------------------------------",
    "------------ttt----------------------------",
    "-----------ttttt---------------------------",
    "-----------r~~tt---------------------------",
    "-----------t~~tt---------------------------",
    "--tt-------t~~tt-----------TR--------------",
    "--tt--------ttt------------Tr--------------",
    "--------------------------------------tt---",
    "--------------------------------------ttt--",
    "--------------------------------------tt---",
    "-------------------------------------------",
    "-------------------------------------------",
    "-------------------------------------------"
  ],
  "achievements": [
    "landscape-architect",
    "farmer-guild"
  ],
  "description": [
    "A medium-sized (43x43) map with vast plains and a few hills and forest patches. Resources are rare.",
    "Available random tiles: 250."
  ],
  "center": {
    "X": 21,
    "Y": 21
  },
  "initial_terrains": 250
}