{
  "terrains": {
    "-": 250,
    "^": 3,
    "r": 3,
    "t": 20,
    "~": 2
  },
  "map": [
    "-------------------------------------------",
    "----------------------------------tt-------",
    "-------------tt------------------tt--------",
    "-------------tt----------------------------",
    "----t--------------------------------------",
    "---t~--------------------------------------",
    "---t~--------------------Tó----------------",
    "-------------------------ó^----------------",
    "-------------------------------------------",
    "-------------ttt----------------------tt---",
    "------------ttttt--------------------tttt--",
    "------------tttT---------------------tttt--",
    "-------------t^^------------tt--------oT---",
    "---------------------------tttt--------ó---",
    "--------------------------tt~~t------------",
    "---------------------------t~~tt-----------",
    "---------------------------ttttt-----------",
    "-------------o-------------óótt------------",
    "--o----------o--------------ó--------------",
    "-oT----------------------------------------",
    "--^----------------------------------------",
    "---------------------A---------------------",
    "---------------tt--------------------------",
    "--------------tttt-------------------------",
    "--------------ttttt------------------------",
    "---------------ttt-------------------------",
    "---------------------------------ott-------",
    "---------------------------------ttt-------",
    "---------------------------------tt--------",
    "-------------------------------------------",
    "-------------------------------------------",
    "------------ttt----------------------------",
    "-----------ttttt---------------------------",
    "-----------o~~tt---------------------------",
    "-----------t~~tt---------------------------",
    "--tt-------t~~tt-----------Tó--------------",
    "--tt--------ttt------------To--------------",
    "--------------------------------------tt---",
    "--------------------------------------ttt--",
    "--------------------------------------tt---",
    "-------------------------------------------",
    "-------------------------------------------",
    "-------------------------------------------"
  ],
  "achievements": [
    "landscape-architect",
    "farmer-guild"
  ],
  "description": [
    "A medium-sized (43x43) map with vast plains and a few hills and forest patches. Resources are rare.",
    "Available random tiles: 250."
  ],
  "center": {
    "X": 21,
    "Y": 21
  },
  "initial_terrains": 250
}