{
  "terrains": {
    "+": 1,
    "-": 20,
    "^": 4,
    "o": 1,
    "t": 6,
    "~": 6
  },
  "map": [
    "----------T-t-oo--^--^^--",
    "--------T-T-tot--^^-^^^^-",
    "--------T-T-ttto--^^^^^--",
    "---t-t-~--~~--~-oo-^^^---",
    "--tt--~~~~~~~~~~----tt---",
    "---~~~~~~~~~~~~~~~---tt--",
    "-tt-~~~~~~~~~~~~~~~-~~~--",
    "---~~~~~~~~~~~~~~~~~~~~--",
    "--tt-~~~~~~~~~~~~~~~~~~--",
    "-----~~~~~~~~~~~~~~~~~~t-",
    "-tt---~~~~~~~~~~~~~~~~tt-",
    "---tt-~~~~~~~~~~~~~~~t-t-",
    "--tt-~~~~~~~~~~~~~~~~t-t-",
    "----t-~~~~~~~~~~~~~~~t---",
    "-t---^--~~~~~~~~~~~~~t---",
    "-ttt-^---~~~~~~~~~~~~~t--",
    "-t-t-^---~~~~~~~~~~~~~t--",
    "----------t~~~~~~~~~~t---",
    "--ttt---A---~~~~~~~~~t---",
    "----^tt----~~~~~~~~~~t---",
    "-tt^^^---tt-~~~~~~~~~~t--",
    "--tt-^tt--t---~~-~~~~~t--",
    "---ttt-------------~t----",
    "---t--t-t--ttttt-t-t-tt--",
    "----tt---tt--tt----------"
  ],
  "achievements": [
    "play-the-game"
  ],
  "description": [
    "A small (25x25) starting area with a centered lake.",
    "Available random tiles: 500."
  ],
  "center": {
    "X": 12,
    "Y": 11 
  },
  "initial_terrains": 500
}
