{
  "terrains": {
    "-": 50,
    "^": 4,
    "r": 1,
    "t": 12,
    "~": 10
  },
  "map": [
    "........................~~...........................",
    "------------------------~~---------------------------",
    "---tt-------------------~~---------------------------",
    "--tTTt-----------tT-----~~~----t^-----tTt------------",
    "--TTTt-----T----tTTt----~r~----^^----tTTTt-----------",
    "--TTr-----------tTTt--tt~-~----------tTTTt-----------",
    "--TT------------TTT----t~~~----------tTTr------------",
    "--T-----T-------TT---t~~~~~----------ttt-------------",
    "-------^^-----------~~~--~~------------------------tT",
    "-------------------t~--t-~~-----------------------tTT",
    "---------------trrt~~---~~~---tTT----------------ttTT",
    "-------------t~~~~r~t---~~~---RTT-----------T----tTTT",
    "----------tttt~tt~~~---t~~~---RTT----------------TTTT",
    "---^-----tTTtt~~ttt----~~~~t--TT-----------------TTTt",
    "---------TTTttr~tt-----~~~~t----------------------tt-",
    "--------tTTT--~~t----tt~tt~tt------------tt----------",
    "-----ttttTT---~ttttt~~~~tt~rt-----------tTTT---------",
    "----tTTTT----t~~~~~~~ttttt~~~t---------tTTTt---------",
    "----TTTt-----~~ttt~tttTTTttr~~t--------TTTt----------",
    "----TTt---ttr~tttt~ttTTTTTttt~ttt--------------------",
    "----------~~~~tt-t~~tTT----tt~~~~t-------------------",
    "-------~~~~tttt---t~~t-------trr~~~t--tt---tt-----T--",
    "------t~rrttTT-----t~t-------ttt~r~~~tr~~~~~~t----^--",
    "------t~~rtTTT------~----------t~-~t~~~~trr~~~t------",
    "-T----tt~~tTTt----r~~-----------~~~tttttttt~r~t------",
    "-^----ttt~tTT----~~~t---h-------t~tt---tTTt~-~-------",
    "-----tttt~tTt----~r~t-----------t~rt----TTt~~~t------",
    "-----tt~~~t------~-~-----------tr~~~------tt~tt------",
    "-----t~~t--------~~~-----------t~~t~~------t~~~tt----",
    "-----t~~~--------~tt---RT-----~~~ttt~--------t~~~t---",
    "------~r~--------~tt---RT----t~t----~~---------t~t---",
    "------~-~--------~~~~t-------t~t----t~---------t~t---",
    "--T---~~~t-------t~t~~~------~~-----t~---------~~----",
    "-------~~~-------~~--t~-----t~t------~~~-------~t----",
    "--------t~-------~t---~t----t~t-------t~~------~-----",
    "---------~------~~----~~-----~t--------t~------~~~-~~",
    "~-------~~------~------~-----~----------~--------~~~~",
    "~~~-----~---~~~~~------~-----~~---------~-----~~~~~~~",
    "~~~~~~~~~~~~~~~~~~~~~~~~~---~~~-----~~~~~~~~~~~~~~~~~",
    "~~~~~~~~~~~~~~~~~~~~~~~~~~~~~~~~~~~~~~~~~~~~~~~~~~~~~",
    "~~~~~~~~~~~~~~~~~~~~~~~~~~~~~~~~~~~~~~~~~~~~~~~~~~~~~",
    "~~~~~~~~~~~~~~~~~~~~~~~~~~~~~~~~~~~~~~~~~~~~~~~~~~~~~",
    "~~~~~~~~~~~~~~~~~~~~~~~~~~~~~~~~~~~~~~~~~~~~~~~~~~~~~",
    "~~~~~~~~~~~~~~~~~~~~~~~~~~~~~~~~~~~~~~~~~~~~~~~~~~~~~",
    "~~~~~~~~~~~~~~~~~~~~~~~~~~~~~~~~~~~~~~~~~~~~~~~~~~~~~"
  ],
  "achievements": [
    "landscape-architect",
    "wood-gnome",
    "fisherman-guild",
    "farmer-guild"
  ],
  "description": [
    "A larger (53x46) map of a river delta. Plenty of resources, but a lot of waterways to bridge.",
    "Available random tiles: 0!"
  ],
  "center": {
    "X": 24,
    "Y": 25
  },
  "initial_terrains": 0
}