{
  "terrains": {
    "-": 50,
    "^": 4,
    "r": 1,
    "t": 12,
    "~": 10
  },
  "map": [
    "........................~~...........................",
    "------------------------~~---------------------------",
    "---tt-------------------~~---------------------------",
    "--tTTt-----------tT-----~~~----t^-----tTt------------",
    "--TTTt-----T----tTTt----~o~----^^----tTTTt-----------",
    "--TTo-----------tTTt--tt~-~----------tTTTt-----------",
    "--TT------------TTT----t~~~----------tTTo------------",
    "--T-----T-------TT---t~~~~~----------ttt-------------",
    "-------^^-----------~~~--~~------------------------tT",
    "-------------------t~--t-~~-----------------------tTT",
    "---------------toot~~---~~~---tTT----------------ttTT",
    "-------------t~~~~o~t---~~~---óTT-----------T----tTTT",
    "----------tttt~tt~~~---t~~~---óTT----------------TTTT",
    "---^-----tTTtt~~ttt----~~~~t--TT-----------------TTTt",
    "---------TTTtto~tt-----~~~~t----------------------tt-",
    "--------tTTT--~~t----tt~tt~tt------------tt----------",
    "-----ttttTT---~ttttt~~~~tt~ot-----------tTTT---------",
    "----tTTTT----t~~~~~~~ttttt~~~t---------tTTTt---------",
    "----TTTt-----~~ttt~tttTTTtto~~t--------TTTt----------",
    "----TTt---tto~tttt~ttTTTTTttt~ttt--------------------",
    "----------~~~~tt-t~~tTT----tt~~~~t-------------------",
    "-------~~~~tttt---t~~t-------too~~~t--tt---tt-----T--",
    "------t~oottTT-----t~t-------ttt~o~~~to~~~~~~t----^--",
    "------t~~otTTT------~----------t~-~t~~~~too~~~t------",
    "-T----tt~~tTTt----o~~-----------~~~tttttttt~o~t------",
    "-^----ttt~tTT----~~~t---A-------t~tt---tTTt~-~-------",
    "-----tttt~tTt----~o~t-----------t~ot----TTt~~~t------",
    "-----tt~~~t------~-~-----------to~~~------tt~tt------",
    "-----t~~t--------~~~-----------t~~t~~------t~~~tt----",
    "-----t~~~--------~tt---óT-----~~~ttt~--------t~~~t---",
    "------~o~--------~tt---óT----t~t----~~---------t~t---",
    "------~-~--------~~~~t-------t~t----t~---------t~t---",
    "--T---~~~t-------t~t~~~------~~-----t~---------~~----",
    "-------~~~-------~~--t~-----t~t------~~~-------~t----",
    "--------t~-------~t---~t----t~t-------t~~------~-----",
    "---------~------~~----~~-----~t--------t~------~~~-~~",
    "~-------~~------~------~-----~----------~--------~~~~",
    "~~~-----~---~~~~~------~-----~~---------~-----~~~~~~~",
    "~~~~~~~~~~~~~~~~~~~~~~~~~---~~~-----~~~~~~~~~~~~~~~~~",
    "~~~~~~~~~~~~~~~~~~~~~~~~~~~~~~~~~~~~~~~~~~~~~~~~~~~~~",
    "~~~~~~~~~~~~~~~~~~~~~~~~~~~~~~~~~~~~~~~~~~~~~~~~~~~~~",
    "~~~~~~~~~~~~~~~~~~~~~~~~~~~~~~~~~~~~~~~~~~~~~~~~~~~~~",
    "~~~~~~~~~~~~~~~~~~~~~~~~~~~~~~~~~~~~~~~~~~~~~~~~~~~~~",
    "~~~~~~~~~~~~~~~~~~~~~~~~~~~~~~~~~~~~~~~~~~~~~~~~~~~~~",
    "~~~~~~~~~~~~~~~~~~~~~~~~~~~~~~~~~~~~~~~~~~~~~~~~~~~~~"
  ],
  "achievements": [
    "landscape-architect",
    "wood-gnome",
    "fisherman-guild",
    "farmer-guild"
  ],
  "description": [
    "A larger (53x46) map of a river delta. Plenty of resources, but a lot of waterways to bridge.",
    "Available random tiles: 0!"
  ],
  "center": {
    "X": 24,
    "Y": 25
  },
  "initial_terrains": 0
}